2223333333333333333333333
7722222222222222222233333
7224444444444444444423333
7244444444444444444442333
7244444444444444444444223
7444444444444444444444423
7444444444444444444444423
7444444444444444444444443
7444444444444444422424443
7444444444444444444444243
7444444444444444444444233
7442222222222222244442333
7444444444444444444423333
7444444444444444442223333
7444444444444444442433333
7444444444444444422333333
7444444422222222233333333
7774777472333333333333333
7777777772333333333333333
7777777777233333333333333
7777777777723333333333333
7777777777772333333333333

