4444444444444444444444444
4444444444444444444444444
4444444444444444444444444
4444444444444444444444444
4444444444444444444444444
4444444444444444444444444
4444444444444444444444444
4444444444444444444444444
4442222222222222222224444
4444444444444444444444444
4444444444444444444444444
4444444444444444444444444
4444444444444444444444444
4444444444444444444444444
4444444444444444444444444
4444444444444444444444444
4444444444444444444444444
3344444444444444444444444
3333344444444444444444444
3333333333444444444444444


