4444444444444444444444444
4444444444444444444444444
4444444444444444444444444
4444444444444444444444444
4444444444444444444444444
4444444444444444444444444
4444444444444444444444444
4444444444444444444444444
4446666666666666666664444
4444444444444444444444444
4444444444444444444444444
4444444444444444444444444
4444444444444444444444444
4444444444444444444444444
4444444444444444444444444
4444444444444444444444444
4444444444444444444444444
3344444444444444444444444
3333344444444444444444444
3333333333444444444444444


