3333333333333333333333333
2222222222222222222233333
4444444444444444444423333
4444444444444444444442333
4444444444444444444444233
4444444444444444444444423
4444444444444444422244423
2244222222222224222244423
4444444444444444424444423
4444444444444444424444432
4444422222222222444444322
4444222222222224444444344
4444444444444444444444444
4444444444444444444444444
4444444444444444444444344
4444444444444444444444444
4444444444444444444444444
3333333333333333333333333
3333333333333333333333333
3333333333333333333333333
3333333333333333333333333
3333333333333333333333333

