4444444444444444444444444
4444444444444444444444444
4444444444444444444444444
4444444444444444444444444
4444444444444444444444444
4444444444444444444444444
4444444444444444444444444
1111111111111111444444111
0000000000000022244442200
0002222222222222224442000
0225555555555555566666555
2555555555555555666666655
5555555555555222222222255
5555555555222222255555552
5555555555555555555555525
5522222222222255555255255
5555555555555555552255555
5555555555555222255555555
5555555555555555555555555
7777777233333333333333333


